11111111
10000001
10000001
1P000001
1C000E11
11111111